13 31
______________________________
|....|................|......P|
|....|......F.........|.......|
|P............................|
|_______________..............|
|....F................|.......|
|...|......|..........|P.....F|
|...|......|.....|....|_______|
|...|......|.....|............|
|.P........|.....|..P.........|
|_____...........________.....|
|.............F...........@...|
|_____________________________|